################################~~~~~~~~################################
~~~~~~~~~~~~====~~~~~~~~~~~~~~~~~~~~~~~~..........................######
~~~~~~~~~~~~====~~~~~~~~~~......,,,,,,,,.................#.#......######
~~~~~~~~~~~~====~~~~~~~~........,,,,,,,,.............##..###..##..######
~~~~~~~~~~~~====~~~~~~~.........~~~~~~~~.............###########..######
######....###,,###..............~~~~~~~~.............#####,#####..######
######..........................~~~~~~~~..........................######
#''''#..........................~##,,##~..........................#""""#
#''''#..........................~#====#~..........................#""""#
#'''''.........................,,,====,,,........................."""""#
#'''''.........................,,,====,,,........................."""""#
#''''#..........................~#====#~..........................#""""#
#''''#..........................~##,,##~..........................#""""#
######..........................~~~~~~~~..........................######
######......#.#.................~~~~~~~~...............##..##~~~~~~~~~~~
######..##..###..##.............~~~~~~~~...............#====#~~~~~~~~~~~
######..###########.............,,,,,,,,................====#~~~~~~~~~~~
######..#####,#####.............,,,,,,,,...............#====#~~~~~~~~~~~
######..........................~~~~~~~~...............#====#~~~~~~~~~~~
################################~~~~~~~~################################
